{
WWWWWWWWWWWWWWWWWWWW
W....W.............W
W....W.............W
W....W.............W
W----W.............W
W----W.............W
W----W             W
WWWWWW             W
W.........WWWWWWWWWW
W..................W
W..................W
W..................W
W..................W
W..................W
W..................W
W..................W
W------------------W
W------------------W
W------------------W
WWWWWWWWWWWWWWWWWWWW
}